    #####
    #   #
#####  O#####
#    _#_    #
# @  ###  O #
#    _#_    #
#####   #####
    # O #
    #  O#
    #   #
    #####
