###########
#@        #        ########
#         ##########   _ _#
#                         #
#   O O   ##########     _#
#     O   #        ########
#         #
###########
