###########
#@        #        ########
#         ##########   _ _#
#                         #
#   O     #### #####     _#
#     O   #  # #   ########
#         #  # #
###########  # #
             # #
       ####### ########
       #          O   #
       #              #
       ################
