##### ####
#___# #  ####
#___###  O  #
#____## O  O###
##____##   O  #
###___ ## O O #
# ##    #  O  #
#  ## # ### ####
# O #@#O  O    #
#  O   O    O  #
#   # O OO O ###
#  ######  ###
# ##    ####
###
